##########################
#121212121212121212121212#
#333333333333333333333333#
#333333333333333333333333#
#333333333333333333333333#
#333333333333333333333333#
#222232322222323223222322#
#333333333333333333333333#
#333333333333333333333333#
#333333333333333333333333#
#333333333333333333333333#
#555555555555555555555555#
#000000000000000000000000#
#000000000000000000000000#
#040404040404040404040404#
#000000000000000000000000#
#000000000000000000000000#
#555555555555555555555555#
#000000000000000000000000#
#000000000000000000000000#
#040404040404040404040404#
#000000000000000000000000#
#000000000000000000000000#
#555555555555555555555555#
#222222222262222222222222#
##########################