##########################
22222222222222222222222222
33333333333333333333333333
33333333333333333333333333
33333333333333333333333333
33333333333333333333333333
22222222222222222222222222
33333333333333333333333333
33333333333333333333333333
33333333333333333333333333
33333333333333333333333333
55555555555555555555555555
00000000000000000000000000
00000000000000000000000000
40404040404040404040404040
00000000000000000000000000
00000000000000000000000000
55555555555555555555555555
00000000000000000000000000
00000000000000000000000000
40404040404040404040404040
00000000000000000000000000
00000000000000000000000000
55555555555555555555555555
22222222222622222222222222
##########################
